#######################################################################################################
|%|                                                                                                  |%|
|%|                                                                                                  |%|
|%|                                                                                                  |%|
|%|                                                                                                  |%|
|%|                                                                                                  |%|
|%|                                                                                                  |%|
|%|                                                                                                  |%|
|%|                                     $$$$$$$$$$$$$$$$$$$                                          |%|
|%|                                                                                                  |%|
|%|                                                                                                  |%|  
|%|                 |%|                                                           ||                 |%|  
|%|                 |%|                                                           ||                 |%|  
|%|                 |%|                                                           ||                 |%|  
|%|                 |%|                                                           ||                 |%|
|%|                 |%|                                                           ||                 |%|
|%|                 |%|                                                           ||                 |%|
|%|                 |%|                                                           ||                 |%|
|%|                 |%|                                                           ||                 |%|
|%|                 |%|################                             ##############||                 |%|
|%|                                                                                                  |%|
|%|                                                                                                  |%|
|%|                                                                                                  |%|
|%|                                                                                                  |%|
|%|                                                                                                  |%|
|%|                                                                                                  |%|
|%|                                                                                                  |%|
|%|                                                                                                  |%|
|%|                                                                                                  |%|
#######################################################################################################